9aox
..............o............
............o...........o..
o......o...................
.........o.................
...............o...........
........o........o......o.o
......................o....
......................o....
...o..o.........o..o....o..
