15.oo
.................o..o......
...................o.......
............o.............o
...........................
....................o.o...o
....................o.o....
...........o...............
o.o.......................o
..o..............o.........
.......o..............o....
...........................
......o.............o.o....
..........................o
...............o...........
...........................
