15.oxk
....................o......
...............o...........
..............o............
.........o................o
.o..............oo.........
...........o...............
....o......................
...........o....o..o.......
o...................o..o...
................o..........
.........o..o.o..o.......o.
.........................o.
.........o.o....o.........o
.......o..o................
.o......o.........o......o.
