9.o7
.o......................o..
......o..o..o....o.........
.o.......o.....o.o.........
........o...o..............
.o..o........o....oo......o
...ooo......o..............
......o.........o..........
o....o.o..............o....
.o...............oo........
