15.3x
..3.......3..........3.....
..................3...3....
............3..............
...3.............3.........
3....3...........3.........
3..3.................3.....
...........................
...........3.....33........
...........3...............
...33...............3......
.....3.3..........3.3..3...
..3........................
...........................
...........................
.3...3.....3...............
