9135
311111111111111131111131113
111133113111333111111111113
111111131111111113111111111
131111111131111111111111111
111311113131111311131311111
111111111111113111111111111
111311111131131111111111131
111111113111111111111111111
111131111111131311311111131
